Dinosauria, Saurischia, Theropoda, Neotherapoda, Tetanurae, Avetherapoda, Coelurosauria, Tyrannoraptora, Maniraptoriformes, Maniraptora, Therizinosauroidea, Beipiaosaurus	inexpectus	Early Cretaceous	Peoples Republic of China
Dinosauria, Saurischia, Sauropodomorpha, Prosauropoda, Plateosauria, Plateosauridae, Mussaurus	patagonicus	Late Triassic	Argentina
Dinosauria, Ornithischia, Genasauria, Cerapoda, Marginocephalia, Ceratopsia, Neoceratopsia, Coronosauria, Ceratopsomorpha, Ceratopsidae, Centrosaurinae, Styracosaurus	albertensis	Late Cretaceous	Canada; USA
Dinosauria, Saurischia, Theropoda, Eoraptor	lunensis	Late Triassic	Argentina
Dinosauria, Saurischia, Theropoda, Neotherapoda, Tetanurae, Avetherapoda, Coelurosauria, Coelurus	fragilis	Late Jurassic	USA
Dinosauria, Ornithischia, Genasauria, Cerapoda, Ornithopoda, Euornithopoda, Leaellynasaura	amicagraphica	Early Cretaceous	Australia
Dinosauria, Saurischia, Theropoda, Neotherapoda, Tetanurae, Avetherapoda, Coelurosauria, Tyrannoraptora, Tyrannosauroidea, Dryptosaurus	aquilunguis	Late Cretaceous	USA
Dinosauria, Saurischia, Sauropodomorpha, Sauropoda, Eusauropoda, Mamenchisaurus	constructus	Late Jurassic	Peoples Republic of China
Dinosauria, Ornithischia, Genasauria, Cerapoda, Marginocephalia, Ceratopsia, Neoceratopsia, Coronosauria, Ceratopsomorpha, Ceratopsidae, Centrosaurinae, Achelousaurus	horneri	Late Cretaceous	USA
Dinosauria, Saurischia, Sauropodomorpha, Sauropoda, Eusauropoda, Aragosaurus	ischiadicus	Early Cretaceous	Spain
Dinosauria, Ornithischia, Genasauria, Thyreophora, Ankylosauromorpha, Ankylosauria, Nodosauridae, Panoplosaurus	mirus	Late Cretaceous	Canada; USA
Dinosauria, Ornithischia, Genasauria, Cerapoda, Ornithopoda, Euornithopoda, Iguanadontia, Euiguanadontia, Dryomorpha, Ankylopollexia, Iguanodontoidea, Probactrosaurus	gobiensis	Early Cretaceous	Peoples Republic of China
Dinosauria, Ornithischia, Genasauria, Cerapoda, Ornithopoda, Euornithopoda, Iguanadontia, Euiguanadontia, Dryomorpha, Ankylopollexia, Iguanodontoidea, Ouranosaurus	nigeriensis	Early Cretaceous	Niger
Dinosauria, Saurischia, Theropoda, Neotherapoda, Tetanurae, Avetherapoda, Coelurosauria, Tyrannoraptora, Maniraptoriformes, Ornithomimosauria, Ornithomimidae, Dromiceiomimus	brevitertius	Late Cretaceous	Canada
Dinosauria, Saurischia, Theropoda, Neotherapoda, Tetanurae, Avetherapoda, Coelurosauria, Tyrannoraptora, Tyrannosauroidea, Tyrannosauridae, Albertosaurinae, Gorgosaurus	libratus	Late Cretaceous	Canada; USA
Dinosauria, Saurischia, Urbacodon	itemirensis	Late Cretaceous	Uzbekistan
Dinosauria, Saurischia, Sauropodomorpha, Sauropoda, Eusauropoda, Neosauropoda, Diplodocoidea, Diplodocidae, Barosaurus	lentus	Late Jurassic	Tanzania; USA
Dinosauria, Saurischia, Sauropodomorpha, Sauropoda, Eusauropoda, Neosauropoda, Macronaria, Camarasauromorpha, Titanosauriformes, Titanosauria, Sonidosaurus	saihangaobiensis	Late Cretaceous	Peoples Republic of China
Dinosauria, Ornithischia, Genasauria, Thyreophora, Ankylosauromorpha, Ankylosauria, Minmi	paravertebra	Early Cretaceous	Australia
Dinosauria, Saurischia, Theropoda, Neotherapoda, Ceratosauria, Neoceratosauria, Abelisauroidea, Abelisauria, Noasaurus	leali	Late Cretaceous	Argentina
Dinosauria, Saurischia, Theropoda, Neotherapoda, Ceratosauria, Neoceratosauria, Elaphrosaurus	bambergi	Late Jurassic	Tanzania
Dinosauria, Saurischia, Sauropodomorpha, Sauropoda, Eusauropoda, Neosauropoda, Macronaria, Camarasauromorpha, Titanosauriformes, Titanosauria, Lithostrotia, Ampelosaurus	atacis	Late Cretaceous	France
Dinosauria, Ornithischia, Genasauria, Cerapoda, Marginocephalia, Ceratopsia, Neoceratopsia, Liaoceratops	yanzigouensis	Early Cretaceous	Peoples Republic of China
Dinosauria, Saurischia, Theropoda, Neotherapoda, Tetanurae, Avetherapoda, Coelurosauria, Proceratosaurus	bradleyi	Mid Jurassic	England; United Kingdom
Dinosauria, Ornithischia, Genasauria, Thyreophora, Ankylosauromorpha, Ankylosauria, Nodosauridae, Struthiosaurus	austriacus	Late Cretaceous	Spain; Austria; France; Romania
Dinosauria, Saurischia, Theropoda, Neotherapoda, Tetanurae, Spinosauroidea, Spinosauridae, Baryonychinae, Baryonyx	walkeri	Early Cretaceous	England; United Kingdom; Spain
Dinosauria, Ornithischia, Pisanosaurus	merti	Late Triassic	Argentina
Dinosauria, Ornithischia, Genasauria, Thyreophora, Ankylosauromorpha, Ankylosauria, Ankylosauridae, Talarurus	plicatospineus	Late Cretaceous	Mongolia
Dinosauria, Saurischia, Theropoda, Neotherapoda, Tetanurae, Avetherapoda, Coelurosauria, Tyrannoraptora, Maniraptoriformes, Maniraptora, Paraves, Eumaniraptora, Dromaeosauridae, Achillobator	giganteus	Late Cretaceous	Mongolia
Dinosauria, Saurischia, Theropoda, Neotherapoda, Tetanurae, Avetherapoda, Carnosauria, Allosauroidea, Allosauridae, Charcharodontosauridae, Giganotosaurinae, Mapusaurus	roseae	Late Cretaceous	Argentina
Dinosauria, Saurischia, Theropoda, Neotherapoda, Tetanurae, Avetherapoda, Coelurosauria, Tyrannoraptora, Maniraptoriformes, Maniraptora, Oviraptorosauria, Hagryphus	giganteus	Late Cretaceous	USA
Dinosauria, Ornithischia, Genasauria, Thyreophora, Ankylosauromorpha, Ankylosauria, Antarctopelta	oliveroi	Late Cretaceous	Antarctica
Dinosauria, Ornithischia, Genasauria, Cerapoda, Heterodontosauridae, Lycorhinus	angustidens	Late Triassic	South Africa
Dinosauria, Saurischia, Theropoda, Neotherapoda, Tetanurae, Avetherapoda, Coelurosauria, Compsognathidae, Sinosauropteryx	prima	Early Cretaceous	Peoples Republic of China
Dinosauria, Ornithischia, Genasauria, Cerapoda, Ornithopoda, Euornithopoda, Iguanadontia, Euiguanadontia, Dryomorpha, Ankylopollexia, Iguanodontoidea, Hadrosauridae, Telmatosaurus	transsylvanicus	Late Cretaceous	Spain; France; Romania
Dinosauria, Ornithischia, Genasauria, Cerapoda, Ornithopoda, Euornithopoda, Iguanadontia, Euiguanadontia, Dryomorpha, Dryosauridae, Dryosaurus	altus	Late Jurassic	Tanzania; USA
Dinosauria, Saurischia, Theropoda, Neotherapoda, Tetanurae, Avetherapoda, Coelurosauria, Tyrannoraptora, Maniraptoriformes, Ornithomimosauria, Ornithomimidae, Gallimimus	bullatus	Late Cretaceous	Mongolia
Dinosauria, Saurischia, Sauropodomorpha, Sauropoda, Eusauropoda, Neosauropoda, Macronaria, Camarasauromorpha, Titanosauriformes, Titanosauria, Hypselosaurus	priscus	Late Cretaceous	Spain; France
Dinosauria, Saurischia, Theropoda, Herrerasauridae, Herrerasaurus	ischigualastensis	Late Triassic	Argentina
Dinosauria, Ornithischia, Genasauria, Cerapoda, Marginocephalia, Ceratopsia, Neoceratopsia, Bagaceratopsidae, Bagaceratops	rozhdestvenskyi	Late Cretaceous	Mongolia
Dinosauria, Ornithischia, Genasauria, Thyreophora, Ankylosauromorpha, Ankylosauria, Polacanthus	foxii	Early Cretaceous	England; United Kingdom
Dinosauria, Saurischia, Theropoda, Neotherapoda, Ceratosauria, Neoceratosauria, Abelisauridae, Abelisaurinae, Abelisaurus	comahuensis	Late Cretaceous	Argentina
Dinosauria, Ornithischia, Genasauria, Cerapoda, Marginocephalia, Ceratopsia, Neoceratopsia, Coronosauria, Protoceratops	andrewsi	Late Cretaceous	Peoples Republic of China; Mongolia
Dinosauria, Saurischia, Theropoda, Neotherapoda, Tetanurae, Avetherapoda, Coelurosauria, Tyrannoraptora, Maniraptoriformes, Maniraptora, Oviraptorosauria, Caenagnathoidea, Oviraptoridae, Ingeniinae, Khaan	mckennai	Late Cretaceous	Mongolia
Dinosauria, Ornithischia, Genasauria, Thyreophora, Scutellosaurus	lawleri	Early Jurassic	USA
Dinosauria, Ornithischia, Genasauria, Cerapoda, Marginocephalia, Ceratopsia, Neoceratopsia, Udanoceratops	tschizhovi	Late Cretaceous	Mongolia
Dinosauria, Saurischia, Sauropodomorpha, Sauropoda, Eusauropoda, Neosauropoda, Macronaria, Bellusaurus	sui	Mid Jurassic	Peoples Republic of China
Dinosauria, Saurischia, Theropoda, Neotherapoda, Tetanurae, Avetherapoda, Gasosaurus	constructus	Mid Jurassic	Peoples Republic of China
Dinosauria, Saurischia, Theropoda, Neotherapoda, Ceratosauria, Coelophysoidea, Coelophysidae, Segisaurus	halli	Mid Jurassic	USA
Dinosauria, Saurischia, Theropoda, Neotherapoda, Tetanurae, Avetherapoda, Coelurosauria, Tyrannoraptora, Maniraptoriformes, Maniraptora, Paraves, Eumaniraptora, Dromaeosauridae, Utahraptor	ostrommaysorum	Early Cretaceous	USA
Dinosauria, Ornithischia, Genasauria, Thyreophora, Ankylosauromorpha, Ankylosauria, Ankylosauridae, Tsagantegia	longicranialis	Late Cretaceous	Mongolia
Dinosauria, Saurischia, Sauropodomorpha, Sauropoda, Eusauropoda, Neosauropoda, Macronaria, Camarasauromorpha, Titanosauriformes, Titanosauria, Lithostrotia, Saltasauridae, Saltasaurus	loricatus	Late Cretaceous	Argentina; Uruguay
Dinosauria, Ornithischia, Genasauria, Thyreophora, Emausaurus	ernsti	Mid Jurassic	Germany
Dinosauria, Saurischia, Theropoda, Neotherapoda, Tetanurae, Avetherapoda, Coelurosauria, Tyrannoraptora, Maniraptoriformes, Ornithomimosauria, Garudimimus	brevipes	Late Cretaceous	Mongolia
Dinosauria, Ornithischia, Genasauria, Cerapoda, Ornithopoda, Euornithopoda, Iguanadontia, Euiguanadontia, Dryomorpha, Ankylopollexia, Iguanodontoidea, Hadrosauridae, Euhadrosauria, Hadrosaurinae, Anatotitan	copei	Late Cretaceous	USA
Dinosauria, Saurischia, Theropoda, Neotherapoda, Tetanurae, Avetherapoda, Carnosauria, Allosauroidea, Sinraptoridae, Yangchuanosaurus	shangyouensis	Late Jurassic	Peoples Republic of China
Dinosauria, Saurischia, Sauropodomorpha, Sauropoda, Eusauropoda, Neosauropoda, Diplodocoidea, Rebbachisauridae, Rebbachisaurus	garasbae	Early Cretaceous	Morocco
Dinosauria, Ornithischia, Genasauria, Thyreophora, Ankylosauromorpha, Ankylosauria, Ankylosauridae, Cedarpelta	bilbeyhallorum	Early Cretaceous	USA
Dinosauria, Ornithischia, Genasauria, Cerapoda, Marginocephalia, Ceratopsia, Neoceratopsia, Chaoyangsaurus	youngi	Late Jurassic	Peoples Republic of China
Dinosauria, Ornithischia, Genasauria, Cerapoda, Ornithopoda, Euornithopoda, Agilisaurus	louderbacki	Late Jurassic	Peoples Republic of China
Dinosauria, Saurischia, Theropoda, Neotherapoda, Tetanurae, Avetherapoda, Coelurosauria, Tyrannoraptora, Tyrannosauroidea, Eotyrannus	lengi	Early Cretaceous	England; United Kingdom
Dinosauria, Ornithischia, Genasauria, Cerapoda, Ornithopoda, Euornithopoda, Iguanadontia, Euiguanadontia, Dryomorpha, Ankylopollexia, Iguanodontoidea, Hadrosauridae, Euhadrosauria, Hadrosaurinae, Brachylophosaurus	canadensis	Late Cretaceous	Canada; USA
Dinosauria, Saurischia, Sauropodomorpha, Sauropoda, Eusauropoda, Neosauropoda, Diplodocoidea, Rebbachisauridae, Nigersaurus	taqueti	Early Cretaceous	Niger; Algeria; Tunisia
Dinosauria, Ornithischia, Genasauria, Cerapoda, Marginocephalia, Ceratopsia, Neoceratopsia, Coronosauria, Leptoceratops	gracilis	Late Cretaceous	Canada; USA
Dinosauria, Saurischia, Theropoda, Neotherapoda, Tetanurae, Avetherapoda, Coelurosauria, Tyrannoraptora, Maniraptoriformes, Maniraptora, Paraves, Eumaniraptoria, Troodontidae, Troodon	formosus	Late Cretaceous	USA
Dinosauria, Saurischia, Theropoda, Neotherapoda, Ceratosauria, Coelophysoidea, Podokesaurus	holyokensis	Mid Jurassic	USA
Dinosauria, Saurischia, Theropoda, Neotherapoda, Tetanurae, Avetherapoda, Carnosauria, Allosauroidea, Allosauridae, Saurophaganax	maximus	Late Jurassic	USA
Dinosauria, Ornithischia, Genasauria, Cerapoda, Marginocephalia, Pachycephalosauria, Goyocephala, Homalocephaloidea, Pachycephalosauridae, Pachycephalosaurus	wyomingensis	Late Cretaceous	Canada; USA
Dinosauria, Saurischia, Sauropodomorpha, Prosauropoda, Plateosauria, Plateosauridae, Euskelosaurus	browni	Late Triassic	Lesotho; South Africa; Zimbabwe
Dinosauria, Ornithischia, Genasauria, Cerapoda, Ornithopoda, Euornithopoda, Bugenasaura	infernalis	Late Cretaceous	USA
Dinosauria, Saurischia, Theropoda, Neotherapoda, Tetanurae, Avetherapoda, Coelurosauria, Tyrannoraptora, Maniraptoriformes, Maniraptora, Therizinosauroidea, Therizinosauridae, Erlikosaurus	andrewsi	Late Cretaceous	Mongolia
Dinosauria, Ornithischia, Genasauria, Cerapoda, Ornithopoda, Euornithopoda, Iguanadontia, Euiguanadontia, Dryomorpha, Ankylopollexia, Iguanodontoidea, Hadrosauridae, Euhadrosauria, Hadrosaurinae, Maiasaura	peeblesorum	Late Cretaceous	USA
Dinosauria, Ornithischia, Genasauria, Thyreophora, Stegosauria, Stegosauridae, Stegosaurinae, Kentrosaurus	aethiopicus	Late Jurassic	Tanzania
Dinosauria, Saurischia, Sauropodomorpha, Sauropoda, Eusauropoda, Neosauropoda, Macronaria, Camarasauromorpha, Titanosauriformes, Brachiosauridae, Brachiosaurus	altithorax	Late Jurassic	Tanzania; USA; Portugal; Algeria
Dinosauria, Ornithischia, Lesothosaurus	diagnosticus	Early Jurassic	Lesotho
Dinosauria, Saurischia, Theropoda, Neotherapoda, Tetanurae, Avetherapoda, Coelurosauria, Tyrannoraptora, Maniraptoriformes, Maniraptora, Oviraptorosauria, Caenagnathoidea, Caenagnathidae, Nomingia	gobiensis	Late Cretaceous	Mongolia
Dinosauria, Ornithischia, Genasauria, Cerapoda, Marginocephalia, Ceratopsia, Psittacosauridae, Psittacosaurus	mongoliensis	Early Cretaceous	Peoples Republic of China; Mongolia; Russia
Dinosauria, Saurischia, Sauropodomorpha, Prosauropoda, Anchisauria, Melanorosauridae, Melanorosaurus	readi	Late Triassic	South Africa
Dinosauria, Ornithischia, Genasauria, Cerapoda, Ornithopoda, Euornithopoda, Iguanadontia, Tenontosaurus	tillettorum	Early Cretaceous	Canada; USA
Dinosauria, Ornithischia, Genasauria, Cerapoda, Marginocephalia, Ceratopsia, Neoceratopsia, Coronosauria, Ceratopsomorpha, Ceratopsidae, Centrosaurinae, Brachyceratops	montanensis	Late Cretaceous	USA
Dinosauria, Saurischia, Sauropodomorpha, Prosauropoda, Yimenosaurus	youngi	Early Jurassic	Peoples Republic of China
Dinosauria, Ornithischia, Genasauria, Cerapoda, Ornithopoda, Euornithopoda, Iguanadontia, Euiguanadontia, Dryomorpha, Ankylopollexia, Iguanodontoidea, Equijubus	normani	Early Cretaceous	Peoples Republic of China
Dinosauria, Ornithischia, Genasauria, Thyreophora, Ankylosauromorpha, Ankylosauria, Gastonia	burgei	Early Cretaceous	USA
Dinosauria, Ornithischia, Genasauria, Thyreophora, Ankylosauromorpha, Ankylosauria, Nodosauridae, Edmontonia	longiceps	Late Cretaceous	Canada
Dinosauria, Saurischia, Theropoda, Neotherapoda, Tetanurae, Avetherapoda, Coelurosauria, Tyrannoraptora, Maniraptoriformes, Maniraptora, Oviraptorosauria, Caenagnathoidea, Oviraptoridae, Ingeniinae, Ingenia	yanshini	Late Cretaceous	Mongolia
Dinosauria, Ornithischia, Genasauria, Cerapoda, Marginocephalia, Pachycephalosauria, Goyocephala, Homalocephaloidea, Pachycephalosauridae, Prenocephale	prenes	Late Cretaceous	Mongolia
Dinosauria, Saurischia, Sauropodomorpha, Sauropoda, Eusauropoda, Yuanmousaurus	jiangyiensis	Mid Jurassic	Peoples Republic of China
Dinosauria, Ornithischia, Genasauria, Cerapoda, Marginocephalia, Ceratopsia, Neoceratopsia, Coronosauria, Ceratopsomorpha, Ceratopsidae, Chasmosaurinae, Triceratops	horridus	Late Cretaceous	USA
Dinosauria, Ornithischia, Genasauria, Cerapoda, Ornithopoda, Euornithopoda, Iguanadontia, Rhabdodontidae, Rhabdodon	priscus	Late Cretaceous	Spain; Austria; France; Romania
Dinosauria, Saurischia, Sauropodomorpha, Sauropoda, Eusauropoda, Neosauropoda, Macronaria, Camarasauromorpha, Titanosauriformes, Titanosauria, Lithostrotia, Saltasauridae, Saltasaurinae, Maxakalisaurus	topai	Late Cretaceous	Brazil
Dinosauria, Saurischia, Sauropodomorpha, Sauropoda, Eusauropoda, Neosauropoda, Diplodocoidea, Nemegtosauridae, Quaesitosaurus	orientalis	Late Cretaceous	Mongolia
Dinosauria, Saurischia, Sauropodomorpha, Sauropoda, Eusauropoda, Neosauropoda, Macronaria, Camarasauromorpha, Titanosauriformes, Titanosauria, Aegyptosaurus	baharijensis	Late Cretaceous	Egypt
Dinosauria, Saurischia, Sauropodomorpha, Sauropoda, Eusauropoda, Amygdalodon	patagonicus	Mid Jurassic	Argentina
Dinosauria, Ornithischia, Genasauria, Cerapoda, Marginocephalia, Ceratopsia, Neoceratopsia, Coronosauria, Ceratopsomorpha, Ceratopsidae, Centrosaurinae, Centrosaurus	apertus	Late Cretaceous	Canada
Dinosauria, Saurischia, Theropoda, Neotherapoda, Tetanurae, Spinosauroidea, Spinosauridae, Spinosaurinae, Irritator	challengeri	Early Cretaceous	Brazil
Dinosauria, Ornithischia, Genasauria, Cerapoda, Marginocephalia, Ceratopsia, Neoceratopsia, Graciliceratops	mongoliensis	Late Cretaceous	Mongolia
Dinosauria, Saurischia, Theropoda, Neotherapoda, Tetanurae, Avetherapoda, Carnosauria, Allosauroidea, Carcharodontosauridae, Carcharodontosaurus	saharicus	Late Cretaceous	North Africa
Dinosauria, Ornithischia, Genasauria, Cerapoda, Ornithopoda, Euornithopoda, Iguanadontia, Euiguanadontia, Dryomorpha, Ankylopollexia, Iguanodontoidea, Hadrosauridae, Euhadrosauria, Lambeosaurinae, Lambeosaurus	lambei	Late Cretaceous	Canada
Dinosauria, Saurischia, Theropoda, Neotherapoda, Tetanurae, Avetherapoda, Coelurosauria, Tyrannoraptora, Tyrannosauroidea, Tyrannosauridae, Tyrannosaurinae, Tyrannosaurus	rex	Late Cretaceous	Canada; USA
Dinosauria, Saurischia, Sauropodomorpha, Sauropoda, Eusauropoda, Neosauropoda, Diplodocoidea, Cetiosauriscus	stewarti	Mid Jurassic	England; United Kingdom
Dinosauria, Ornithischia, Genasauria, Cerapoda, Ornithopoda, Euornithopoda, Iguanadontia, Euiguanadontia, Dryomorpha, Ankylopollexia, Iguanodontoidea, Jinzhousaurus	yangi	Early Cretaceous	Peoples Republic of China
Dinosauria, Saurischia, Theropoda, Neotherapoda, Tetanurae, Avetherapoda, Coelurosauria, Tyrannoraptora, Maniraptoriformes, Maniraptora, Paraves, Eumaniraptora, Dromaeosauridae, Unenlagiinae, Buitreraptor	gonzalezorum	Late Cretaceous	Argentina
Dinosauria, Ornithischia, Genasauria, Cerapoda, Ornithopoda, Euornithopoda, Iguanadontia, Euiguanadontia, Dryomorpha, Ankylopollexia, Iguanodontoidea, Hadrosauridae, Euhadrosauria, Hadrosaurinae, Gryposaurus	notabilis	Late Cretaceous	Canada; USA
Dinosauria, Saurischia, Theropoda, Neotherapoda, Ceratosauria, Coelophysoidea, Liliensternus	liliensterni	Late Triassic	Germany; France
Dinosauria, Ornithischia, Genasauria, Thyreophora, Ankylosauromorpha, Ankylosauria, Ankylosauridae, Shamosaurus	scutatus	Early Cretaceous	Mongolia
Dinosauria, Ornithischia, Genasauria, Cerapoda, Marginocephalia, Ceratopsia, Neoceratopsia, Coronosauria, Ceratopsomorpha, Zuniceratops	christopheri	Late Cretaceous	USA
Dinosauria, Ornithischia, Genasauria, Cerapoda, Ornithopoda, Euornithopoda, Atlascopcosaurus	loadsi	Early Cretaceous	Australia
Dinosauria, Saurischia, Theropoda, Neotherapoda, Tetanurae, Spinosauroidea, Megalosauridae, Eustreptospondylinae, Piatnitzkysaurus	floresi	Late Jurassic	Argentina
Dinosauria, Saurischia, Theropoda, Neotherapoda, Tetanurae, Avetherapoda, Carnosauria, Allosauroidea, Allosauridae, Allosaurus	fragilis	Late Jurassic	Portugal; USA
Dinosauria, Saurischia, Theropoda, Neotherapoda, Tetanurae, Spinosauroidea, Megalosauridae, Eustreptospondylinae, Afrovenator	abakensis	Early Cretaceous	Niger
Dinosauria, Saurischia, Sauropodomorpha, Sauropoda, Vulcanodontidae, Vulcanodon	karibaensis	Early Jurassic	Zimbabwe
Dinosauria, Ornithischia, Genasauria, Cerapoda, Marginocephalia, Ceratopsia, Neoceratopsia, Coronosauria, Ceratopsomorpha, Ceratopsidae, Chasmosaurinae, Anchiceratops	ornatus	Late Cretaceous	Canada
Dinosauria, Ornithischia, Genasauria, Cerapoda, Ornithopoda, Euornithopoda, Iguanadontia, Euiguanadontia, Dryomorpha, Ankylopollexia, Iguanodontoidea, Hadrosauridae, Euhadrosauria, Hadrosaurinae, Lophorhothon	atopus	Late Cretaceous	USA
Dinosauria, Ornithischia, Genasauria, Cerapoda, Ornithopoda, Euornithopoda, Zephyrosaurus	schaffi	Early Cretaceous	USA
Dinosauria, Ornithischia, Genasauria, Cerapoda, Ornithopoda, Euornithopoda, Iguanadontia, Euiguanadontia, Dryomorpha, Ankylopollexia, Iguanodontoidea, Iguanodon	bernissartensis	Early Cretaceous	England; United Kingdom; Germany; USA; Spain; Belgium
Dinosauria, Saurischia, Sauropodomorpha, Prosauropoda, Plateosauria, Plateosauridae, Massospondylus	carinatus	Early Jurassic	Lesotho; South Africa; Zimbabwe
Dinosauria, Saurischia, Theropoda, Neotherapoda, Tetanurae, Avetherapoda, Coelurosauria, Deltadromeus	agilis	Late Cretaceous	Morocco
Dinosauria, Ornithischia, Genasauria, Cerapoda, Ornithopoda, Euornithopoda, Iguanadontia, Euiguanadontia, Dryomorpha, Ankylopollexia, Iguanodontoidea, Fukuisaurus	tetoriensius	Early Cretaceous	Japan
Dinosauria, Ornithischia, Genasauria, Cerapoda, Marginocephalia, Ceratopsia, Neoceratopsia, Bagaceratopsidae, Lamaceratops	tereschenkoi	Late Cretaceous	Mongolia
Dinosauria, Saurischia, Sauropodomorpha, Sauropoda, Eusauropoda, Neosauropoda, Macronaria, Camarasauromorpha, Titanosauriformes, Titanosauria, Erketu	ellisoni	Early Cretaceous	Mongolia
Dinosauria, Ornithischia, Genasauria, Cerapoda, Marginocephalia, Pachycephalosauria, Goyocephala, Homalocephaloidea, Homalocephale	calathocercos	Late Cretaceous	Mongolia
Dinosauria, Ornithischia, Genasauria, Cerapoda, Ornithopoda, Euornithopoda, Orodromeus	makelai	Late Cretaceous	USA
Dinosauria, Saurischia, Sauropodomorpha, Sauropoda, Eusauropoda, Cetiosauridae, Cetiosaurus	oxoniensis	Mid Jurassic	England; United Kingdom
Dinosauria, Saurischia, Theropoda, Neotherapoda, Tetanurae, Avetherapoda, Coelurosauria, Tyrannoraptora, Tyrannosauroidea, Alioramus	remotus	Late Cretaceous	Mongolia
Dinosauria, Saurischia, Theropoda, Neotherapoda, Tetanurae, Avetherapoda, Coelurosauria, Tyrannoraptora, Tyrannosauroidea, Guanlong	wucaii	Late Jurassic	Peoples Republic of China
Dinosauria, Ornithischia, Genasauria, Cerapoda, Ornithopoda, Euornithopoda, Iguanadontia, Euiguanadontia, Dryomorpha, Dryosauridae, Valdosaurus	canaliculatus	Early Cretaceous	England; United Kingdom; Niger; Romania
Dinosauria, Ornithischia, Genasauria, Cerapoda, Marginocephalia, Ceratopsia, Neoceratopsia, Coronosauria, Ceratopsomorpha, Ceratopsidae, Chasmosaurinae, Torosaurus	latus	Late Cretaceous	Canada; USA
Dinosauria, Saurischia, Sauropodomorpha, Sauropoda, Eusauropoda, Neosauropoda, Macronaria, Camarasauromorpha, Titanosauriformes, Titanosauria, Lithostrotia, Paralititan	stromeri	Late Cretaceous	Egypt
Dinosauria, Saurischia, Sauropodomorpha, Sauropoda, Eusauropoda, Neosauropoda, Macronaria, Camarasauromorpha, Titanosauriformes, Titanosauria, Lithostrotia, Saltasauridae, Opisthocoelicaudia	skarzynskii	Late Cretaceous	Mongolia
Dinosauria, Saurischia, Theropoda, Neotherapoda, Tetanurae, Avetherapoda, Coelurosauria, Tyrannoraptora, Tyrannosauroidea, Alectrosaurus	olseni	Late Cretaceous	Peoples Republic of China; Mongolia
Dinosauria, Saurischia, Theropoda, Neotherapoda, Tetanurae, Avetherapoda, Coelurosauria, Tyrannoraptora, Maniraptoriformes, Maniraptora, Alvarezsauridae, Mononykus	olecranus	Late Cretaceous	Peoples Republic of China; Mongolia
Dinosauria, Saurischia, Theropoda, Neotherapoda, Tetanurae, Avetherapoda, Carnosauria, Monolophosaurus	jiangi	Mid Jurassic	Peoples Republic of China
Dinosauria, Saurischia, Theropoda, Neotherapoda, Tetanurae, Avetherapoda, Coelurosauria, Tyrannoraptora, Maniraptoriformes, Maniraptora, Paraves, Eumaniraptora, Dromaeosauridae, Bambiraptor	feinbergorum	Late Cretaceous	USA
Dinosauria, Saurischia, Theropoda, Neotherapoda, Tetanurae, Spinosauroidea, Megalosauridae, Megalosaurinae, Poekilopleuron	bucklandii	Mid Jurassic	France
Dinosauria, Saurischia, Sauropodomorpha, Sauropoda, Eusauropoda, Neosauropoda, Macronaria, Camarasauromorpha, Camarasauridae, Haplocanthosaurus	priscus	Late Jurassic	USA
Dinosauria, Saurischia, Theropoda, Neotherapoda, Tetanurae, Avetherapoda, Coelurosauria, Tyrannoraptora, Maniraptoriformes, Maniraptora, Oviraptorosauria, Caenagnathoidea, Oviraptoridae, Ingeniinae, Conchoraptor	gracilis	Late Cretaceous	Mongolia
Dinosauria, Ornithischia, Genasauria, Thyreophora, Stegosauria, Stegosauridae, Stegosaurinae, Hesperosaurus	mjosi	Late Jurassic	USA
Dinosauria, Ornithischia, Genasauria, Cerapoda, Ornithopoda, Euornithopoda, Iguanadontia, Euiguanadontia, Dryomorpha, Ankylopollexia, Iguanodontoidea, Hadrosauridae, Bactrosaurus	johnsoni	Late Cretaceous	Peoples Republic of China
Dinosauria, Saurischia, Theropoda, Neotherapoda, Tetanurae, Avetherapoda, Coelurosauria, Tyrannoraptora, Maniraptoriformes, Maniraptora, Therizinosauroidea, Therizinosauridae, Therizinosaurus	cheloniformis	Late Cretaceous	Mongolia
Dinosauria, Saurischia, Theropoda, Neotherapoda, Tetanurae, Avetherapoda, Coelurosauria, Tyrannoraptora, Maniraptoriformes, Maniraptora, Alvarezsauridae, Shuvuuia	deserti	Late Cretaceous	Mongolia
Dinosauria, Saurischia, Theropoda, Neotherapoda, Tetanurae, Avetherapoda, Coelurosauria, Nqwebasaurus	thwazi	Mid Jurassic	South Africa
Dinosauria, Saurischia, Sauropodomorpha, Prosauropoda, Anchisauria, Melanorosauridae, Avalonia	sanfordi	Late Triassic	England; United Kingdom
Dinosauria, Saurischia, Theropoda, Neotherapoda, Tetanurae, Avetherapoda, Coelurosauria, Tyrannoraptora, Tyrannosauroidea, Tyrannosauridae, Tyrannosaurinae, Tarbosaurus	bataar	Late Cretaceous	Peoples Republic of China; Mongolia
Dinosauria, Ornithischia, Genasauria, Cerapoda, Ornithopoda, Euornithopoda, Iguanadontia, Euiguanadontia, Dryomorpha, Ankylopollexia, Iguanodontoidea, Muttaburrasaurus	langdoni	Early Cretaceous	Australia
Dinosauria, Saurischia, Sauropodomorpha, Sauropoda, Chinshakiangosaurus	zhongheensis	Late Jurassic	Peoples Republic of China
Dinosauria, Ornithischia, Genasauria, Thyreophora, Ankylosauromorpha, Ankylosauria, Nodosauridae, Sauropelta	edwardsorum	Early Cretaceous	USA
Dinosauria, Ornithischia, Genasauria, Cerapoda, Ornithopoda, Euornithopoda, Iguanadontia, Euiguanadontia, Dryomorpha, Ankylopollexia, Camptosaurus	dispar	Late Jurassic	England; United Kingdom; USA
Dinosauria, Saurischia, Sauropodomorpha, Prosauropoda, Anchisauria, Anchisauridae, Anchisaurus	polyzelous	Early Jurassic	USA
Dinosauria, Ornithischia, Genasauria, Thyreophora, Stegosauria, Huayangosauridae, Huayangosaurus	taibaii	Mid Jurassic	Peoples Republic of China
Dinosauria, Saurischia, Theropoda, Neotherapoda, Tetanurae, Avetherapoda, Coelurosauria, Tyrannoraptora, Maniraptoriformes, Maniraptora, Paraves, Eumaniraptora, Dromaeosauridae, Microraptor	zhaoianus	Early Cretaceous	Peoples Republic of China
Dinosauria, Saurischia, Theropoda, Guaibasaurus	candelariensis	Late Triassic	Brazil
Dinosauria, Saurischia, Theropoda, Neotherapoda, Ceratosauria, Neoceratosauria, Abelisauroidea, Abelisauria, Aucasaurus	garridoi	Late Cretaceous	Argentina
Dinosauria, Saurischia, Theropoda, Neotherapoda, Tetanurae, Avetherapoda, Coelurosauria, Tyrannoraptora, Maniraptoriformes, Maniraptora, Paraves, Eumaniraptora, Dromaeosauridae, Deinonychus	antirrhopus	Early Cretaceous	USA
Dinosauria, Ornithischia, Genasauria, Thyreophora, Ankylosauromorpha, Ankylosauria, Ankylosauridae, Saichania	chulsanensis	Late Cretaceous	Mongolia
Dinosauria, Saurischia, Sauropodomorpha, Sauropoda, Eusauropoda, Neosauropoda, Macronaria, Camarasauromorpha, Titanosauriformes, Titanosauria, Argentinosaurus	huinculensis	Late Cretaceous	Argentina
Dinosauria, Ornithischia, Genasauria, Cerapoda, Ornithopoda, Euornithopoda, Iguanadontia, Rhabdodontidae, Zalmoxes	robustus	Late Cretaceous	Romania
Dinosauria, Saurischia, Pantydraco	caducus	Early Jurassic	Wales; United Kingdom
Dinosauria, Ornithischia, Genasauria, Cerapoda, Ornithopoda, Euornithopoda, Iguanadontia, Euiguanadontia, Dryomorpha, Ankylopollexia, Iguanodontoidea, Hadrosauridae, Euhadrosauria, Hadrosaurinae, Hadrosaurus	foulkii	Late Cretaceous	USA
Dinosauria, Ornithischia, Genasauria, Cerapoda, Heterodontosauridae, Heterodontosaurus	tucki	Early Jurassic	Lesotho; South Africa
Dinosauria, Ornithischia, Genasauria, Thyreophora, Ankylosauromorpha, Ankylosauria, Gargoyleosaurus	parkpinorum	Late Jurassic	USA
Dinosauria, Saurischia, Sauropodomorpha, Sauropoda, Eusauropoda, Neosauropoda, Macronaria, Camarasauromorpha, Titanosauriformes, Titanosauria, Lithostrotia, Alamosaurus	sanjuanensis	Late Cretaceous	USA
Dinosauria, Ornithischia, Genasauria, Cerapoda, Ornithopoda, Euornithopoda, Iguanadontia, Euiguanadontia, Dryomorpha, Ankylopollexia, Iguanodontoidea, Hadrosauridae, Euhadrosauria, Lambeosaurinae, Nipponosaurus	sachalinensis	Late Cretaceous	Russia
Dinosauria, Ornithischia, Genasauria, Cerapoda, Marginocephalia, Ceratopsia, Neoceratopsia, Archaeoceratops	oshimai	Early Cretaceous	Peoples Republic of China
Dinosauria, Saurischia, Sauropodomorpha, Sauropoda, Eusauropoda, Neosauropoda, Macronaria, Camarasauromorpha, Titanosauriformes, Pelorosaurus	conybearei	Early Cretaceous	England; United Kingdom
Dinosauria, Ornithischia, Genasauria, Cerapoda, Ornithopoda, Euornithopoda, Iguanadontia, Euiguanadontia, Dryomorpha, Ankylopollexia, Iguanodontoidea, Hadrosauridae, Euhadrosauria, Hadrosaurinae, Saurolophus	osborni	Late Cretaceous	Canada; Mongolia
Dinosauria, Ornithischia, Genasauria, Thyreophora, Scelidosauridae, Scelidosaurus	harrisonii	Early Jurassic	England; United Kingdom
Dinosauria, Ornithischia, Genasauria, Cerapoda, Ornithopoda, Euornithopoda, Iguanadontia, Euiguanadontia, Dryomorpha, Ankylopollexia, Iguanodontoidea, Lurdusaurus	arenatus	Early Cretaceous	Niger
Dinosauria, Ornithischia, Genasauria, Cerapoda, Marginocephalia, Pachycephalosauria, Micropachycephalosaurus	hongtuyanensis	Late Cretaceous	Peoples Republic of China
Dinosauria, Ornithischia, Genasauria, Cerapoda, Ornithopoda, Euornithopoda, Iguanadontia, Euiguanadontia, Dryomorpha, Ankylopollexia, Iguanodontoidea, Hadrosauridae, Gilmoreosaurus	mongoliensis	Late Cretaceous	Peoples Republic of China
Dinosauria, Saurischia, Theropoda, Neotherapoda, Tetanurae, Avetherapoda, Coelurosauria, Tyrannoraptora, Maniraptoriformes, Maniraptora, Paraves, Eumaniraptora, Dromaeosauridae, Sinornithosaurus	millenii	Early Cretaceous	Peoples Republic of China
Dinosauria, Saurischia, Theropoda, Neotherapoda, Ceratosauria, Neoceratosauria, Abelisauridae, Carnotaurus	sastrei	Late Cretaceous	Argentina
Dinosauria, Saurischia, Theropoda, Neotherapoda, Tetanurae, Avetherapoda, Coelurosauria, Tyrannoraptora, Maniraptoriformes, Maniraptora, Paraves, Eumaniraptora, Protarchaeopteryx	robusta	Early Cretaceous	Peoples Republic of China
Dinosauria, Saurischia, Theropoda, Neotherapoda, Tetanurae, Avetherapoda, Carnosauria, Fukuiraptor	kitadaniensis	Early Cretaceous	Japan
Dinosauria, Saurischia, Sauropodomorpha, Prosauropoda, Plateosauria, Plateosauridae, Plateosaurus	engelhardti	Late Triassic	Germany; France; Switzerland
Dinosauria, Ornithischia, Genasauria, Thyreophora, Stegosauria, Stegosauridae, Stegosaurinae, Tuojiangosaurus	multispinus	Late Jurassic	Peoples Republic of China
Dinosauria, Saurischia, Theropoda, Neotherapoda, Tetanurae, Avetherapoda, Coelurosauria, Tyrannoraptora, Maniraptoriformes, Ornithomimosauria, Ornithomimidae, Anserimimus	planinychus	Late Cretaceous	Mongolia
Dinosauria, Saurischia, Theropoda, Neotherapoda, Tetanurae, Avetherapoda, Carnosauria, Cryolophosaurus	elliotti	Early Jurassic	Antarctica
Dinosauria, Saurischia, Theropoda, Neotherapoda, Ceratosauria, Neoceratosauria, Abelisauridae, Rugops	primus	Late Cretaceous	Niger
Dinosauria, Saurischia, Theropoda, Neotherapoda, Tetanurae, Avetherapoda, Coelurosauria, Tyrannoraptora, Maniraptoriformes, Ornithomimosauria, Ornithomimidae, Ornithomimus	velox	Late Cretaceous	Canada; USA
Dinosauria, Ornithischia, Genasauria, Thyreophora, Ankylosauromorpha, Ankylosauria, Ankylosauridae, Ankylosaurus	magniventris	Late Cretaceous	Canada; USA
Dinosauria, Saurischia, Sauropodomorpha, Prosauropoda, Plateosauria, Plateosauridae, Coloradisaurus	brevis	Late Triassic	Argentina
Dinosauria, Saurischia, Sauropodomorpha, Sauropoda, Eusauropoda, Neosauropoda, Macronaria, Europasaurus	holgeri	Late Jurassic	Germany
Dinosauria, Ornithischia, Genasauria, Cerapoda, Ornithopoda, Euornithopoda, Iguanadontia, Euiguanadontia, Dryomorpha, Ankylopollexia, Iguanodontoidea, Hadrosauridae, Euhadrosauria, Hadrosaurinae, Kritosaurus	navajovius	Late Cretaceous	Argentina; USA
Dinosauria, Saurischia, Theropoda, Neotherapoda, Tetanurae, Avetherapoda, Coelurosauria, Compsognathidae, Juravenator	starki	Late Jurassic	Germany
Dinosauria, Saurischia, Theropoda, Neotherapoda, Tetanurae, Metriacanthosaurus	parkeri	Late Jurassic	England; United Kingdom
Dinosauria, Ornithischia, Genasauria, Cerapoda, Ornithopoda, Euornithopoda, Iguanadontia, Euiguanadontia, Dryomorpha, Ankylopollexia, Iguanodontoidea, Eolambia	caroljonesa	Late Cretaceous	USA
Dinosauria, Ornithischia, Genasauria, Cerapoda, Ornithopoda, Euornithopoda, Iguanadontia, Euiguanadontia, Dryomorpha, Ankylopollexia, Iguanodontoidea, Hadrosauridae, Euhadrosauria, Lambeosaurinae, Jaxartosaurus	aralensis	Late Cretaceous	Kazakhstan
Dinosauria, Ornithischia, Genasauria, Thyreophora, Ankylosauromorpha, Ankylosauria, Ankylosauridae, Pinacosaurus	grangeri	Late Cretaceous	Peoples Republic of China; Mongolia
Dinosauria, Ornithischia, Genasauria, Thyreophora, Stegosauria, Stegosauridae, Stegosaurinae, Chungkingosaurus	jiangbeiensis	Late Jurassic	Peoples Republic of China
Dinosauria, Ornithischia, Genasauria, Thyreophora, Stegosauria, Stegosauridae, Stegosaurinae, Stegosaurus	armatus	Late Jurassic	USA
Dinosauria, Saurischia, Theropoda, Neotherapoda, Tetanurae, Avetherapoda, Coelurosauria, Tyrannoraptora, Maniraptoriformes, Ornithomimosauria, Deinocheirus	mirificus	Late Cretaceous	Mongolia
Dinosauria, Saurischia, Sauropodomorpha, Sauropoda, Datousaurus	bashanensis	Mid Jurassic	Peoples Republic of China
Dinosauria, Ornithischia, Albertaceratops	nesmoi	Late Cretaceous	Canada; USA
Dinosauria, Saurischia, Theropoda, Neotherapoda, Tetanurae, Avetherapoda, Coelurosauria, Tyrannoraptora, Maniraptoriformes, Maniraptora, Paraves, Eumaniraptoria, Troodontidae, Borogovia	gracilicrus	Late Cretaceous	Mongolia
Dinosauria, Saurischia, Theropoda, Neotherapoda, Tetanurae, Spinosauroidea, Spinosauridae, Baryonychinae, Suchomimus	tenerensis	Early Cretaceous	Niger
Dinosauria, Saurischia, Sauropodomorpha, Prosauropoda, Anchisauria, Aardonyx	celestae	Early Jurassic	South Africa
Dinosauria, Saurischia, Theropoda, Neotherapoda, Ceratosauria, Neoceratosauria, Ceratosaurus	nasicornis	Late Jurassic	USA
Dinosauria, Ornithischia, Genasauria, Thyreophora, Stegosauria, Stegosauridae, Dacentrurus	armatus	Late Jurassic	England; United Kingdom; Portugal; France
Dinosauria, Saltopus, Saltopus	elginensis	Late Triassic	Scotland; United Kingdom
Dinosauria, Ornithischia, Genasauria, Cerapoda, Marginocephalia, Ceratopsia, Neoceratopsia, Coronosauria, Ceratopsomorpha, Ceratopsidae, Chasmosaurinae, Pentaceratops	sternbergi	Late Cretaceous	USA
Dinosauria, Ornithischia, Genasauria, Cerapoda, Ornithopoda, Euornithopoda, Iguanadontia, Euiguanadontia, Dryomorpha, Ankylopollexia, Iguanodontoidea, Hadrosauridae, Euhadrosauria, Lambeosaurinae, Hypacrosaurus	altispinus	Late Cretaceous	Canada; USA
Dinosauria, Saurischia, Theropoda, Neotherapoda, Ceratosauria, Coelophysoidea, Dilophosaurus	wetherilli	Early Jurassic	USA
Dinosauria, Saurischia, Sauropodomorpha, Sauropoda, Eusauropoda, Neosauropoda, Macronaria, Camarasauromorpha, Titanosauriformes, Titanosauria, Lithostrotia, Isisaurus	colberti	Late Cretaceous	India
Dinosauria, Ornithischia, Genasauria, Cerapoda, Ornithopoda, Euornithopoda, Yandusaurus	hongheensis	Mid Jurassic	Peoples Republic of China
Dinosauria, Saurischia, Sauropodomorpha, Sauropoda, Eusauropoda, Neosauropoda, Diplodocoidea, Dicraeosauridae, Dicraeosaurus	hansemanni	Late Jurassic	Tanzania
Dinosauria, Saurischia, Sauropodomorpha, Prosauropoda, Plateosauria, Jingshanosaurus	xinwaensis	Early Jurassic	Peoples Republic of China
Dinosauria, Saurischia, Theropoda, Neotherapoda, Tetanurae, Avetherapoda, Coelurosauria, Tyrannoraptora, Maniraptoriformes, Maniraptora, Therizinosauroidea, Therizinosauridae, Nothronychus	mckinleyi	Late Cretaceous	USA
Dinosauria, Ornithischia, Genasauria, Thyreophora, Ankylosauromorpha, Ankylosauria, Nodosauridae, Silvisaurus	condrayi	Early Cretaceous	USA
Dinosauria, Ornithischia, Genasauria, Cerapoda, Ornithopoda, Euornithopoda, Iguanadontia, Euiguanadontia, Dryomorpha, Ankylopollexia, Iguanodontoidea, Hadrosauridae, Secernosaurus	koerneri	Late Cretaceous	Argentina
Dinosauria, Saurischia, Theropoda, Neotherapoda, Tetanurae, Avetherapoda, Coelurosauria, Tyrannoraptora, Tyrannosauroidea, Tyrannosauridae, Albertosaurinae, Albertosaurus	libratus	Late Cretaceous	Canada
Dinosauria, Ornithischia, Genasauria, Cerapoda, Marginocephalia, Ceratopsia, Neoceratopsia, Coronosauria, Ceratopsomorpha, Ceratopsidae, Centrosaurinae, Pachyrhinosaurus	canadensis	Late Cretaceous	Canada
Dinosauria, Ornithischia, Genasauria, Cerapoda, Marginocephalia, Pachycephalosauria, Goyocephala, Homalocephaloidea, Pachycephalosauridae, Tylocephale	gilmorei	Late Cretaceous	Mongolia
Dinosauria, Ornithischia, Genasauria, Cerapoda, Marginocephalia, Ceratopsia, Neoceratopsia, Coronosauria, Microceratops	gobiensis	Late Cretaceous	Peoples Republic of China; Mongolia
Dinosauria, Ornithischia, Genasauria, Cerapoda, Ornithopoda, Euornithopoda, Gasparinisaura	cincosaltensis	Late Cretaceous	Argentina
Dinosauria, Saurischia, Sauropodomorpha, Prosauropoda, Plateosauria, Plateosauridae, Lufengosaurus	huenei	Early Jurassic	Peoples Republic of China
Dinosauria, Saurischia, Sauropodomorpha, Sauropoda, Rhoetosaurus	brownei	Mid Jurassic	Australia
Dinosauria, Ornithischia, Genasauria, Cerapoda, Ornithopoda, Euornithopoda, Iguanadontia, Euiguanadontia, Dryomorpha, Ankylopollexia, Iguanodontoidea, Hadrosauridae, Euhadrosauria, Hadrosaurinae, Edmontosaurus	regalis	Late Cretaceous	Canada
Dinosauria, Saurischia, Sauropodomorpha, Sauropoda, Eusauropoda, Shunosaurus	lii	Mid Jurassic	Peoples Republic of China
Dinosauria, Saurischia, Theropoda, Neotherapoda, Tetanurae, Spinosauroidea, Megalosauridae, Eustreptospondylinae, Eustreptospondylus	oxoniensis	Mid Jurassic	England; United Kingdom
Dinosauria, Saurischia, Sauropodomorpha, Sauropoda, Eusauropoda, Neosauropoda, Diplodocoidea, Dicraeosauridae, Amargasaurus	cazaui	Early Cretaceous	Argentina
Dinosauria, Saurischia, Theropoda, Neotherapoda, Ceratosauria, Coelophysoidea, Procompsognathus	triassicus	Late Triassic	Germany
Dinosauria, Saurischia, Theropoda, Neotherapoda, Tetanurae, Spinosauroidea, Spinosauridae, Spinosaurinae, Spinosaurus	aegyptiacus	Late Cretaceous	Egypt; Morocco
Dinosauria, Saurischia, Sauropodomorpha, Sauropoda, Eusauropoda, Neosauropoda, Macronaria, Camarasauromorpha, Titanosauriformes, Titanosauria, Janenschia	robusta	Late Jurassic	Tanzania
Dinosauria, Ornithischia, Oryctodromeus	cubicularis	Late Cretaceous	USA
Dinosauria, Ornithischia, Genasauria, Thyreophora, Ankylosauromorpha, Ankylosauria, Ankylosaurinae, Tarchia	gigantea	Late Cretaceous	Mongolia
Dinosauria, Saurischia, Sauropodomorpha, Sauropoda, Eusauropoda, Omeisaurus	junghsiensis	Mid Jurassic	Peoples Republic of China
Dinosauria, Ornithischia, Genasauria, Cerapoda, Marginocephalia, Pachycephalosauria, Goyocephala, Homalocephaloidea, Pachycephalosauridae, Stegoceras	validum	Late Cretaceous	Canada; USA
Dinosauria, Saurischia, Sauropodomorpha, Sauropoda, Eusauropoda, Cetiosauridae, Barapasaurus	tagorei	Early Jurassic	India
Dinosauria, Saurischia, Theropoda, Neotherapoda, Tetanurae, Avetherapoda, Carnosauria, Allosauroidea, Sinraptoridae, Sinraptor	hepingensis	Mid Jurassic	Peoples Republic of China
Dinosauria, Saurischia, Theropoda, Neotherapoda, Tetanurae, Avetherapoda, Carnosauria, Allosauroidea, Carcharodontosauridae, Acrocanthosaurus	atokensis	Early Cretaceous	Canada; USA
Dinosauria, Saurischia, Sauropodomorpha, Sauropoda, Kotasaurus	yamanpalliensis	Early Jurassic	India
Dinosauria, Saurischia, Sauropodomorpha, Prosauropoda, Plateosauria, Yunnanosaurus	huangi	Early Jurassic	Peoples Republic of China
Dinosauria, Saurischia, Sauropodomorpha, Sauropoda, Eusauropoda, Neosauropoda, Macronaria, Camarasauromorpha, Titanosauriformes, Brachiosauridae, Giraffatitan	brancai	Late Jurassic	Tanzania
Dinosauria, Saurischia, Sauropodomorpha, Sauropoda, Eusauropoda, Neosauropoda, Macronaria, Camarasauromorpha, Titanosauriformes, Titanosauria, Ligabuesaurus	leanzai	Early Cretaceous	Argentina
Dinosauria, Ornithischia, Genasauria, Cerapoda, Ornithopoda, Euornithopoda, Iguanadontia, Euiguanadontia, Dryomorpha, Ankylopollexia, Iguanodontoidea, Protohadros	byrdi	Late Cretaceous	USA
Dinosauria, Saurischia, Sauropodomorpha, Sauropoda, Eusauropoda, Neosauropoda, Diplodocoidea, Dicraeosauridae, Brachytrachelopan	mesai	Mid Jurassic	Argentina
Dinosauria, Saurischia, Sauropodomorpha, Sauropoda, Eusauropoda, Neosauropoda, Macronaria, Camarasauromorpha, Titanosauriformes, Titanosauria, Lithostrotia, Malawisaurus	dixeyi	Early Cretaceous	Malawi
Dinosauria, Ornithischia, Genasauria, Cerapoda, Ornithopoda, Euornithopoda, Othnielia	rex	Late Jurassic	USA
Dinosauria, Saurischia, Theropoda, Herrerasauridae, Staurikosaurus	pricei	Late Triassic	Brazil
Dinosauria, Saurischia, Theropoda, Neotherapoda, Ceratosauria, Coelophysoidea, Coelophysidae, Coelophysis	bauri	Late Triassic	USA
Dinosauria, Ornithischia, Genasauria, Thyreophora, Ankylosauromorpha, Ankylosauria, Ankylosauridae, Gobisaurus	domoculus	Early Cretaceous	Peoples Republic of China
Dinosauria, Ornithischia, Genasauria, Cerapoda, Ornithopoda, Euornithopoda, Iguanadontia, Euiguanadontia, Dryomorpha, Ankylopollexia, Iguanodontoidea, Hadrosauridae, Euhadrosauria, Hadrosaurinae, Prosaurolophus	maximus	Late Cretaceous	Canada; USA
Dinosauria, Saurischia, Theropoda, Neotherapoda, Tetanurae, Avetherapoda, Coelurosauria, Tyrannoraptora, Maniraptoriformes, Ornithomimosauria, Harpymimus	okladnikovi	Early Cretaceous	Mongolia
Dinosauria, Ornithischia, Genasauria, Cerapoda, Marginocephalia, Ceratopsia, Neoceratopsia, Coronosauria, Ceratopsomorpha, Ceratopsidae, Chasmosaurinae, Chasmosaurus	belli	Late Cretaceous	Canada
Dinosauria, Ornithischia, Genasauria, Cerapoda, Marginocephalia, Ceratopsia, Neoceratopsia, Coronosauria, Ceratopsomorpha, Ceratopsidae, Centrosaurinae, Avaceratops	lammersi	Late Cretaceous	USA
Dinosauria, Saurischia, Theropoda, Neotherapoda, Tetanurae, Spinosauroidea, Megalosauridae, Megalosaurinae, Torvosaurus	tanneri	Late Jurassic	USA
Dinosauria, Saurischia, Sauropodomorpha, Sauropoda, Eusauropoda, Neosauropoda, Macronaria, Camarasauromorpha, Titanosauriformes, Lapparentosaurus	madagascariensis	Mid Jurassic	Madagascar
Dinosauria, Ornithischia, Genasauria, Cerapoda, Marginocephalia, Ceratopsia, Neoceratopsia, Coronosauria, Ceratopsomorpha, Ceratopsidae, Chasmosaurinae, Diceratops	hatcheri	Late Cretaceous	USA
Dinosauria, Saurischia, Sauropodomorpha, Sauropoda, Eusauropoda, Neosauropoda, Macronaria, Jobaria	tiguidensis	Early Cretaceous	Niger
Dinosauria, Saurischia, Theropoda, Neotherapoda, Tetanurae, Avetherapoda, Coelurosauria, Tyrannoraptora, Tyrannosauroidea, Tyrannosauridae, Tyrannosaurinae, Daspletosaurus	torosus	Late Cretaceous	Canada
Dinosauria, Saurischia, Theropoda, Neotherapoda, Tetanurae, Avetherapoda, Coelurosauria, Tyrannoraptora, Tyrannosauroidea, Tyrannosauridae, Tyrannosaurinae, Nanotyrannus	lancenis	Late Cretaceous	USA
Dinosauria, Saurischia, Theropoda, Neotherapoda, Tetanurae, Avetherapoda, Coelurosauria, Tyrannoraptora, Maniraptoriformes, Maniraptora, Paraves, Eumaniraptoria, Troodontidae, Saurornithoides	mongoliensis	Late Cretaceous	Mongolia
Dinosauria, Ornithischia, Genasauria, Thyreophora, Stegosauria, Stegosauridae, Stegosaurinae, Chialingosaurus	kuani	Late Jurassic	Peoples Republic of China
Dinosauria, Saurischia, Sauropodomorpha, Prosauropoda, Anchisauria, Anchisauridae, Ammosaurus	major	Early Jurassic	USA
Dinosauria, Saurischia, Theropoda, Neotherapoda, Ceratosauria, Sarcosaurus	woodi	Early Jurassic	England; United Kingdom
Dinosauria, Saurischia, Theropoda, Neotherapoda, Tetanurae, Avetherapoda, Coelurosauria, Compsognathidae, Compsognathus	longipes	Late Jurassic	Germany; France
Dinosauria, Ornithischia, Genasauria, Cerapoda, Ornithopoda, Euornithopoda, Iguanadontia, Euiguanadontia, Dryomorpha, Ankylopollexia, Iguanodontoidea, Hadrosauridae, Euhadrosauria, Hadrosaurinae, Aralosaurus	tuberiferus	Late Cretaceous	Kazakhstan
Dinosauria, Saurischia, Sauropodomorpha, Sauropoda, Eusauropoda, Neosauropoda, Macronaria, Camarasauromorpha, Camarasauridae, Camarasaurus	supremus	Late Jurassic	USA
Dinosauria, Ornithischia, Genasauria, Cerapoda, Marginocephalia, Ceratopsia, Neoceratopsia, Bagaceratopsidae, Platyceratops	tatarinovi	Late Cretaceous	Mongolia
Dinosauria, Saurischia, Theropoda, Neotherapoda, Tetanurae, Avetherapoda, Coelurosauria, Ornitholestes	hermanni	Late Jurassic	USA
Dinosauria, Saurischia, Theropoda, Neotherapoda, Tetanurae, Avetherapoda, Coelurosauria, Tyrannoraptora, Maniraptoriformes, Ornithomimosauria, Ornithomimidae, Struthiomimus	altus	Late Cretaceous	Canada
Dinosauria, Ornithischia, Genasauria, Thyreophora, Ankylosauromorpha, Ankylosauria, Hylaeosaurus	armatus	Early Cretaceous	England; United Kingdom
Dinosauria, Saurischia, Sauropodomorpha, Sauropoda, Eusauropoda, Cetiosauridae, Patagosaurus	fariasi	Mid Jurassic	Argentina
Dinosauria, Saurischia, Theropoda, Neotherapoda, Ceratosauria, Neoceratosauria, Abelisauridae, Majungatholus	atopus	Late Cretaceous	Madagascar
Dinosauria, Ornithischia, Genasauria, Cerapoda, Ornithopoda, Euornithopoda, Iguanadontia, Euiguanadontia, Dryomorpha, Ankylopollexia, Iguanodontoidea, Hadrosauridae, Euhadrosauria, Hadrosaurinae, Shantungosaurus	giganteus	Late Cretaceous	Peoples Republic of China
Dinosauria, Saurischia, Theropoda, Neotherapoda, Tetanurae, Avetherapoda, Coelurosauria, Tyrannoraptora, Maniraptoriformes, Maniraptora, Paraves, Eumaniraptora, Dromaeosauridae, Dromaeosaurus	albertensis	Late Cretaceous	Canada; USA
Dinosauria, Ornithischia, Genasauria, Cerapoda, Ornithopoda, Euornithopoda, Iguanadontia, Euiguanadontia, Dryomorpha, Ankylopollexia, Iguanodontoidea, Hadrosauridae, Euhadrosauria, Lambeosaurinae, Parasaurolophus	walkeri	Late Cretaceous	Canada; USA
Dinosauria, Saurischia, Sauropodomorpha, Sauropoda, Eusauropoda, Neosauropoda, Macronaria, Camarasauromorpha, Titanosauriformes, Titanosauria, Lithostrotia, Antarctosaurus	wichmannianus	Late Cretaceous	Argentina; Chile; Uruguay
Dinosauria, Saurischia, Theropoda, Neotherapoda, Tetanurae, Avetherapoda, Coelurosauria, Tyrannoraptora, Maniraptoriformes, Maniraptora, Therizinosauroidea, Therizinosauridae, Segnosaurus	galbinensis	Late Cretaceous	Mongolia
Dinosauria, Ornithischia, Genasauria, Cerapoda, Ornithopoda, Euornithopoda, Iguanadontia, Euiguanadontia, Dryomorpha, Ankylopollexia, Iguanodontoidea, Hadrosauridae, Tanius	sinensis	Late Cretaceous	Peoples Republic of China
Dinosauria, Saurischia, Sauropodomorpha, Sauropoda, Eusauropoda, Neosauropoda, Diplodocoidea, Nemegtosauridae, Nemegtosaurus	mongoliensis	Late Cretaceous	Mongolia
Dinosauria, Saurischia, Theropoda, Neotherapoda, Tetanurae, Avetherapoda, Carnosauria, Allosauroidea, Carcharodontosauridae, Giganotosaurus	carolinii	Early Cretaceous	Argentina
Dinosauria, Saurischia, Theropoda, Neotherapoda, Tetanurae, Becklespinax	altispinax	Early Cretaceous	England; United Kingdom
Dinosauria, Ornithischia, Genasauria, Cerapoda, Marginocephalia, Pachycephalosauria, Goyocephala, Goyocephale	lattimorei	Late Cretaceous	Mongolia
Dinosauria, Saurischia, Theropoda, Neotherapoda, Tetanurae, Avetherapoda, Coelurosauria, Tyrannoraptora, Maniraptoriformes, Maniraptora, Oviraptorosauria, Caudipterygidae, Caudipteryx	zoui	Early Cretaceous	Peoples Republic of China
Dinosauria, Saurischia, Theropoda, Neotherapoda, Tetanurae, Avetherapoda, Coelurosauria, Tyrannoraptora, Maniraptoriformes, Maniraptora, Alvarezsauridae, Alvarezsaurus	calvoi	Late Cretaceous	Argentina
Dinosauria, Ornithischia, Genasauria, Thyreophora, Stegosauria, Stegosauridae, Dravidosaurus	blanfordi	Late Cretaceous	India
Dinosauria, Saurischia, Theropoda, Neotherapoda, Tetanurae, Avetherapoda, Coelurosauria, Tyrannoraptora, Maniraptoriformes, Maniraptora, Paraves, Eumaniraptora, Dromaeosauridae, Unenlagia	comahuensis	Late Cretaceous	Argentina
Dinosauria, Saurischia, Theropoda, Herrerasauridae, Chindesaurus	bryansmalli	Late Triassic	USA
Dinosauria, Ornithischia, Genasauria, Cerapoda, Marginocephalia, Pachycephalosauria, Goyocephala, Homalocephaloidea, Pachycephalosauridae, Dracorex	hogwartsia	Late Cretaceous	USA
Dinosauria, Saurischia, Sauropodomorpha, Sauropoda, Eusauropoda, Neosauropoda, Macronaria, Camarasauromorpha, Titanosauriformes, Titanosauria, Chubutisaurus	insignis	Early Cretaceous	Argentina
Dinosauria, Ornithischia, Genasauria, Cerapoda, Ornithopoda, Euornithopoda, Thescelosaurus	neglectus	Late Cretaceous	Canada; USA
Dinosauria, Saurischia, Theropoda, Neotherapoda, Tetanurae, Avetherapoda, Coelurosauria, Tyrannoraptora, Maniraptoriformes, Maniraptora, Oviraptorosauria, Caenagnathoidea, Oviraptoridae, Oviraptorinae, Oviraptor	philoceratops	Late Cretaceous	Mongolia
Dinosauria, Saurischia, Theropoda, Neotherapoda, Ceratosauria, Neoceratosauria, Indosuchus	raptorius	Late Cretaceous	India
Dinosauria, Ornithischia, Genasauria, Thyreophora, Ankylosauromorpha, Ankylosauria, Ankylosauridae, Euoplocephalus	tutus	Late Cretaceous	Canada; USA
Dinosauria, Ornithischia, Genasauria, Cerapoda, Marginocephalia, Pachycephalosauria, Goyocephala, Homalocephaloidea, Pachycephalosauridae, Stygimoloch	spinifer	Late Cretaceous	USA
Dinosauria, Saurischia, Theropoda, Neotherapoda, Tetanurae, Avetherapoda, Coelurosauria, Tyrannoraptora, Maniraptoriformes, Maniraptora, Paraves, Eumaniraptora, Dromaeosauridae, Velociraptor	mongoliensis	Late Cretaceous	Mongolia
Dinosauria, Saurischia, Theropoda, Neotherapoda, Tetanurae, Avetherapoda, Coelurosauria, Tyrannoraptora, Maniraptoriformes, Maniraptora, Paraves, Eumaniraptoria, Avialae, Archaeopterygidae, Archaeopteryx	lithographica	Late Jurassic	Germany
Dinosauria, Ornithischia, Genasauria, Cerapoda, Ornithopoda, Euornithopoda, Parksosaurus	warrenae	Late Cretaceous	Canada
Dinosauria, Ornithischia, Genasauria, Cerapoda, Ornithopoda, Euornithopoda, Iguanadontia, Euiguanadontia, Dryomorpha, Ankylopollexia, Iguanodontoidea, Hadrosauridae, Euhadrosauria, Lambeosaurinae, Corythosaurus	casuarius	Late Cretaceous	Canada; USA
Dinosauria, Saurischia, Theropoda, Neotherapoda, Tetanurae, Avetherapoda, Coelurosauria, Tyrannoraptora, Maniraptoriformes, Maniraptora, Oviraptorosauria, Caenagnathoidea, Oviraptoridae, Oviraptorinae, Citipati	osmolskae	Late Cretaceous	Mongolia
Dinosauria, Saurischia, Sauropodomorpha, Prosauropoda, Azendohsaurus	laaroussi	Late Triassic	Morocco
Dinosauria, Ornithischia, Genasauria, Cerapoda, Marginocephalia, Ceratopsia, Neoceratopsia, Coronosauria, Ceratopsomorpha, Ceratopsidae, Centrosaurinae, Einiosaurus	procurvicornis	Late Cretaceous	USA
Dinosauria, Saurischia, Theropoda, Neotherapoda, Tetanurae, Avetherapoda, Coelurosauria, Tyrannoraptora, Maniraptoriformes, Ornithomimosauria, Ornithomimidae, Archaeornithomimus	asiaticus	Late Cretaceous	Peoples Republic of China; Uzbekistan
Dinosauria, Saurischia, Lophostropheus	airelensis	Early Jurassic	France
Dinosauria, Saurischia, Theropoda, Neotherapoda, Tetanurae, Spinosauroidea, Megalosauridae, Eustreptospondylinae, Dubreuillosaurus	valesdunensis	Late Jurassic	France
Dinosauria, Saurischia, Theropoda, Neotherapoda, Ceratosauria, Neoceratosauria, Abelisauroidea, Abelisauria, Masiakasaurus	knopfleri	Late Cretaceous	Madagascar
Dinosauria, Saurischia, Theropoda, Neotherapoda, Tetanurae, Avetherapoda, Coelurosauria, Tyrannoraptora, Maniraptoriformes, Maniraptora, Oviraptorosauria, Avimimidae, Avimimus	portentosus	Late Cretaceous	Peoples Republic of China; Mongolia
Dinosauria, Saurischia, Sauropodomorpha, Sauropoda, Eusauropoda, Neosauropoda, Macronaria, Camarasauromorpha, Titanosauriformes, Titanosauria, Austrosaurus	mckillopi	Early Cretaceous	Australia
Dinosauria, Ornithischia, Genasauria, Thyreophora, Stegosauria, Yingshanosaurus	jichuanensis	Late Jurassic	Peoples Republic of China
Dinosauria, Saurischia, Theropoda, Neotherapoda, Tetanurae, Avetherapoda, Marshosaurus	bicentesimus	Late Jurassic	USA
Dinosauria, Ornithischia, Genasauria, Cerapoda, Ornithopoda, Euornithopoda, Hypsilophodontidae, Hypsilophodon	foxii	Early Cretaceous	England; United Kingdom; Spain
Dinosauria, Saurischia, Sauropodomorpha, Sauropoda, Eusauropoda, Neosauropoda, Diplodocoidea, Diplodocidae, Diplodocus	longus	Late Jurassic	USA
Dinosauria, Saurischia, Theropoda, Neotherapoda, Tetanurae, Spinosauroidea, Megalosauridae, Megalosaurinae, Megalosaurus	bucklandii	Mid Jurassic	England; United Kingdom
Dinosauria, Saurischia, Sauropodomorpha, Sauropoda, Eusauropoda, Neosauropoda, Diplodocoidea, Diplodocidae, Apatosaurus	ajax	Late Jurassic	USA
Dinosauria, Saurischia, Sauropodomorpha, Sauropoda, Eusauropoda, Neosauropoda, Macronaria, Camarasauromorpha, Titanosauriformes, Pleurocoelus	nanus	Early Cretaceous	USA
Dinosauria, Saurischia, Theropoda, Neotherapoda, Tetanurae, Avetherapoda, Carnosauria, Allosauroidea, Carcharodontosauridae, Neovenator	salerii	Early Cretaceous	England; United Kingdom
Dinosauria, Ornithischia, Genasauria, Thyreophora, Ankylosauromorpha, Ankylosauria, Nodosauridae, Nodosaurus	textilis	Early Cretaceous	USA
